200 200 2200 2200 30
WWWWWWWWWWWWWWWWWWWWWWWWWWWWWWWWWWWWWWWWWWWWWWWWWWWWWWWWWWWWW
WFFFFFFFFFFFFFFFFFFFFFFFFFFFFFFFFFFFFFFFFFFFFFFFFFFFFFFFFFFFW
WFFFFFFFFFFFFFFFFWWWWWWWWWWWWWWWWFFFFFFFFFFFFFFFFFFFFFFFFFFFW
WFFFFFFFFFFFFFFFFWFFFFFFFFFFFFFFWFFFFFFFFFFFFFFFFFFFFFFFFFFFW
WFFFFFFFFFFFFFFFFWFFFFFFFFFFFFFFDFFFFFFFFFFFFFFFFFFFFFFFFFFFW
WFFFFFFFFFFFFFFFFWFFFFFFFFFFFFFFDFFFFFFFFFFFFFFFFFFFFFFFFFFFW
WFFFFFFFFFFFFFFFFWFFFFFFFFFFFFFFWFFFFFFFFFFFFFFFFFFFFFFFFFFFW
WFFFFFFFFFFFFFFFFWWWWWWWWWWWWWWWWFFFFFFFFFFFFFFFFFFFFFFFFFFFW
WFFFFFFFFFFFFFFFFFFFFFFFFFFFFFFFFFFFFFFFFFFFFFFFFFFFFFFFFFFFW
WFFFFFFFFFFFFFFFFFFFFFFFFFFFFFFFFFFFFFFFFFFFFFFFFFFFFFFFFFFFW
WFFFFFFFFFFFFFFFFFFFFFFFFFFFFFFFFFFFFFFFFFFFFFFFFFFFFFFFFFFFW
WFFFFFFFFFFFFFFFFFFFFFFFFFFFFFFFFFFFFFFFFFFFFFFFFFFFFFFFFFFFW
WFFFFFFFFFFFFFFFFFFWWWWWWWWWWWWWWWWWWWWWWWWWWWWWWWWWWWWWWWWWW
WFFFFFFFFFFFFFFFFFFFFFFFFFFFFFFFFFFFFFFFFFFFFFFFFFFFFFFFFFFFW
WFFFFFFFFFFFFFFFFFFFFFFFFFFFFFFFFFFFFFFFFFFFFFFFFFFFFFFFFFFFW
WWWWWWWWWWWWWWWWWWWWWWWWWWWWWWWWWWWWWWWWWWWWWWFFFFFFFFFFFFFFW
WFFFFFFFFFFFFFFFFFFFFFFFFFFFFFFFFFFFFFFFFFFFFFFFFFFFFFFFFFFFW
WFFFFFFFFFFFFFFFFFFFFFFFFFFFFFFFFFFFFFFFFFFFFFFFFFFFFFFFFFFFW
WFFFFFFFFFFFFFFFFFFFFFFFFFFFFFFFFFFFFFFFFFFFFFFFFFFFFFFFFFFFW
WFFFFFFFFFFFFFFFWWWWWWWWWWWWWWWWWWWWWWWWWWWWWWWWWWWWWWWWWWWWW
WFFFFFFFFFFFFFFFFFFFFFFFFFFFFFFFFFFFFFFFFFFFFFFFFFFFFFFFFFFFW
WFFFFFFFFFFFFFFFFFFFFFFFFFFFFFFFFFFFFFFFFFFFFFFFFFFFFFFFFFFFW
WFFFFFFFFFFFFFFFFFFFFFFFFFFFFFFFFFFFFFFFFFFFFFFFFFFFFFFFFFFFW
WFFFFFFFFFFFFFFFFFFFFFFFFFFFFFFFFFFFFFFFFFFFFFFFFFFFFFFFFFFFW
WWWWWWWWWWWWWWWWWWWWWWWWWWWWWFFFFFFFFFFFFFFFFFFFFFFFFFFFFFFFW
WFFFFFFFFFFFFFFFFFFFFFFFFFFFFFFFFFFFFFFFFFFFFFFFFFFFFFFFFFFFW
WFFFFFFFFFFFFFFFFFFFFFFFFFFFFFFFFFFFFFFFFFFFFFFFFFFFFFFFFFFFW
WFFFFFFFFFFFFFFFFFFFFFFFFFFFFFFFFFFFFFFFFFFFFFFFFFFFFFFFFFFFW
WFFFFFFFFFFFFFFFFFFFFFFFFFFFFFFFFFFFFFFFFFFFFFFFFFFFFFFFFFFFW
WWWWWWWWWWWWWWWWWWWWWWWWWWWWWWWWWWWWWWWWWWWWWWWWWWWWWWWWWWWWW
