playerx playery mapedgex mapedgey maprows
WWWWWWWWWWWWWWWWWWWWWWWWWWWWWWWWWWWWWWWWWWWWWWWWWWWWWWWWWWWWWWWW
WFFFFFFFFFFFFFFFFFFFFFFFFFFFFFFFFFFFFFFFFFFFFFFFFFFFFFFFFFFFFFFW
WFFFFFFFFFFFFFFFFFFFWWWWWWWWWWWWWWWWWWWWWFFFFFFFFFFFFFFFFFFFFFFW
WFFFFFFFFFFFFFFFFFFFWFFFFFFFFFFFFFFFFFFFWFFFFFFFFFFFFFFFFFFFFFFW
WFFFFFFFFFFFFFFFFFFFWFFFFFFFFFFFFFFFFFFFDFFFFFFFFFFFFFFFFFFFFFFW
WFFFFFFFFFFFFFFFFFFFWFFFFFFFFFFFFFFFFFFFWFFFFFFFFFFFFFFFFFFFFFFW
WFFFFFFFFFFFFFFFFFFFWFFFFFFFFFFFFFFFFFFFWFFFFFFFFFFFFFFFFFFFFFFW
WFFFFFFFFFFFFFFFFFFFWWWWWWWWWWWWWWWWWWWWWFFFFFFFFFFFFFFFFFFFFFFW
WFFFFFFFFFFFFFFFFFFFFFFFFFFFFFFFFFFFFFFFFFFFFFFFFFFFFFFFFFFFFFFW
WFFFFFFFFFFFFFFFFFFFFFFFFFFFFFFFFFFFFFFFFFFFFFFFFFFFFFFFFFFFFFFW
WFFFFFFFFFFFFFFFFFFFFFFFFFFFFFFFFFFFFFFFFFFFFFFFFFFFFFFFFFFFFFFW
WFFFFFFFFFFFFFFFFFFFFFFFFFFFFFFFFFFFFFFFFFFFFFFFFFFFFFFFFFFFFFFW
WFFFFFFFFFFFFFFFFFFFFFFFFFFFFFFFFFFFWWWWWWWWWWWWWWWWWWWWWWWWWWWW
WFFFFFFFFFFFFFFFFFFFFFFFFFFFFFFFFFFFFFFFFFFFFFFFFFFFFFFFFFFFFFFW
WFFFFFFFFFFFFFFFFFFFFFFFFFFFFFFFFFFFFFFFFFFFFFFFFFFFFFFFFFFFFFFW
WFFFFFFFFFFFWWWWWWWWWWWWWWWWWWWWWWWWWWWWWWWWWWWWWWWWWWWWFFFFFFFW
WWWWWWWWWWWWWWWWWWWWWWWWWWWWWWWWWWWWWWWWWWWWWWWWFFFFFFFFFFFFFFFW
WWWWWWWWWWWWWWWWWWWWWWWWWWWWWWWWWWWWWWWWWWWWWWWWWWWWWWWWWWWWWWWW
